000000000000000000000000000000000000000030000000000000000000000000000000000000000000000000000000000000000000000000000000000000000000000000000000000000000000000000000000000000000000000000000000000000000000000000000000000000000000000000000000
000000000000000000000000000000000000000222000000000000000000000000000000000000000000000000000000000000000000000000000000000000000000000000000002000000222220000000000000000000000000000000000000000000000000000000000000000000000000000000000000
000000000000000000000000000000000000002111200000000000000000000000000000000000000000000000000000000000000000000000000000000000000000000022020001000022111110000000000000000000000000000000000000000000000000000000000000000200000000000000000000
000000003000000000000000000000000000021111122000000000000000000000000000000000000000000000000000000000000000000000000000000002000000002211212221000011111112222222200000000000000000000000000000000000000000000000000000022122000000000000000000
000000022220000000000000000000000022211111111222000000000000000000000000000000000000030000000000000000000000000000000000000221220002221111111111222211111111111111122222220000000000000000000000000000000000000000000002211111200000000000000000
000000000000000000000000000000000211111111111111222000000000000000002220000000000200020020002222222222200000222222222222222111112221111111111111111111111111111111111111112222220000000000004400000000022222222222222221111111122222222222222222
220000000000000002200000222000022111111111111111111222222222000220000000000000200000000000001111111111110000011111111111111111111111111111111111111111111111111111111111111111112222000000002222222222211111111111111111111111111111111111111111
112222222222222221100002111000011111111111111111111111111111000000000000022200000000000000001111111111111000011111111111111111111111111111111111111111111111111111111111111111111111000000001111111111111111111111111111111111111111111111111111
111111111111111111100001111200011111111111111111111111111111000000000000000000000000000000001111111111111100000011111111000000000000000000000000000000000000000000000000000000000001000000001111111111111111111111111111111111111111111111111111
111111111111111111100000110100011100100111000001000000111100000000000000000000000000000000001111111111111110000001100000000000000000000000000000000000000000000000000000000000000001110000001000000000000000000000000000000000000000000000000000
111111111111111111100000010000011000000010000000000000011000000000000000000000000000000000001111111111111111100000000000000000000000000000000000000000000000000000000000000000000000000000001000000000000000000000000000000000000000000000000000
111111111111111111100000010000010000000000000000000000001000000000000000000000000000000000001111111111111111111000000000000000000000000000400000000000000000000000000000000300000000000044001000000000000000000000000000000000000000000000000000
111111111111111111100000000000000000000000000000000000000000000000000000000000000000000000001111111111111111111111110100100100001001000001111000100001000010000010000010000100001000011111111000000000000000000000000000000000000000000000000000
