1600000000000051
1002222443333001
1000000000000001
1000000000000001
1600000000000051
1040000000080221
1000000000044001
1000070000000001
1600000000000051
1040000000000001
1000040000000001
1000000000000001
1000000004400001
1000000000000001
1600000000000001
1000000000000001
1000040000000001
1000000000000051
1000000000222221
1080000000000001
1040000000000001
1600000000000051
1000000004000001
1000000000000001
1000000000000001
1000002430000001
1000000000000001
1600000000000051
1024300000243001
1000000000000071
1000000000000001
1000000000000001
1000022433000001
1000000000000001
1000000000000001
1000000000000051
1000000000022221
1000000000000001
1600700000000001
1333330000000001
1000000000007051
1000000000222221
1000000000000001
1000000000000001
1000000000000001
1000002443000001
1000000000000001
1600000000000051
1008000000000001
1004004000040001
1000000000000001
1000000000000051
1000000000000001
1000000000022221
1000000000000001
1600000000000001
1007000000000001
1333330000000001
1000000000000001
1600000000000051
1000000000000001
1111111111111111
